PPPPPPPPPP
PSSSSSSPSP
PSSP35PPSP
PPPPSSSJPP
PSSSSSSPSP
PLSPSSSS2P
PSSSSS4PSP
PPSSSSSSSP
PSSSSSSSSP
PPPPPPPPPP